.............
.#.#.#.#.#.#.
.#.#.#.#.#.#.
.#.#.#.#.#.#.
.#.#.#.#.#.#.
.#.#.....#.#.
.....#.#.....
#.##.....##.#
.....###.....
.#.#.#.#.#.#.
.#.#.#.#.#.#.
.#.#.....#.#.
.............