.............
.#.#.#.#.#.#.
.#.#.#.#.#.#.
.#.#.#.#.#.#.
.#.#.#.#.#.#.
.#.#.....#.#.
.....###.....
#.##.....##.#
.....#.#.....
.#.#.#.#.#.#.
.#.#.#.#.#.#.
.#.#.#.#.#.#.
.............