..........................
..........................
..##..##..##..##..##..##..
..##..##..##..##..##..##..
..##..##..##..##..##..##..
..##..##..##..##..##..##..
..##..##..##..##..##..##..
..##..##..##..##..##..##..
..##..##..##..##..##..##..
..##..##..........##..##..
..##..##..........##..##..
..........##..##..........
..........##..##..........
##..####..........####..##
....####..........####....
..........##..##..........
..........######..........
..##..##..######..##..##..
..##..##..##..##..##..##..
..##..##..##..##..##..##..
..##..##..##..##..##..##..
..##..##..........##..##..
..##..##..........##..##..
..##..##...####...##..##..
...........#..#...........
...........#..#...........